11111111111111111
100000000E1C00001
10000000001000001
11001111111000001
10F00000000000001
10000000000000001
1000000000100F001
11001111111100011
100001C0001000001
10000100F01000001
10F00110011000001
10000000001000001
1C000000001000001
11111111111110011
100001000001000F1
10P00000000000001
1000000010F000001
11111111111111111